1111111111
1E00000001
1000000001
1000000001
1000000001
1000000001
1000000001
1000000001
1000000CP1
1111111111
