1111111111111111
1E00000000000001
1000000000000001
1000000000000001
1000000000000001
1000000000000001
1000000000000001
1000000000000001
10C0000000000001
10C0000000000001
10C00P0000000001
1111111111111111
