11111111111111111111
1E000000000000000001
10000000000000000001
10000000000000000001
1000CC0000000CC00001
1000CC0000000CC00001
10000000000000000001
10000000000000000001
100000000000000000P1
10000000000000000001
10000000000000000001
10000000000000000001
10000000000000000001
10000000000000000001
1000CC0000000CC00001
1000CC0000000CC00001
10000000000000000001
10000000000000000001
10000000000000000001
11111111111111111111
