111111111111111111111111111111
1E0000000000000000000000000001
100000000000000000000000000001
100000000000000000000000000001
10000000000000CC0000000CC00001
1000CC00000000000000000CC00001
100000000000000000000000000001
100000000000000000000000000001
1000000000000000000000000000P1
100000000000000000000000000001
100000000000000000000000000001
100000000000000000000000000001
100000000000000000000000000001
100000000000000000000000000001
1000CC00000000000000000CC00001
1000CC00000000000000000CC00001
100000000000000000000000000001
100000000000000000000000000001
100000000000000000000000000001
111111111111111111111111111111
