1111111
1P00001
10C1C01
1011101
10C1C01
10C1C01
10C1C01
10C1C01
10000E1
1111111
