11111111111111111111
1E000000000000000001
10000000000000000001
10000000000000000001
1000CC0000000CC00001
1000CC0000000CC00001
10000011111100000001
10000011111100000001
100000111111000000P1
10000011111100000001
10000011111100000001
10000011111100000001
10000011111100000001
10000011111100000001
1000CC1111110CC00001
1000CC1111110CC00001
10000011111100000001
10000011111100000001
10000011111100000001
10000000000000000001
10000000000000000001
10000000000000000001
1000CC00000000000001
1000CC00000000000001
10000000000000CC0001
1000C0000000000C0001
1000CC00000000000001
1000CC00000000000001
10000000000000000001
11111111111111111111
