11111111
1P000001
10000001
10000001
11100111
1C0001E1
11111111
