		NO 			TestParsing/assets/north_text.xpm
		SO 			TestParsing/assets/south_text.xpm
		WE 			TestParsing/assets/west_text.xpm
		EA 			TestParsing/assets/east_text.xpm



  C 		255,255,255
   F		 0,0,0



        1111111111111111111111111
        1000000000110000000000001
        1011000001110000000000001
        1001000000000000000000001
111111111011000001110000000000001
100000000011000001110111110111111
11110111111111011100000010001
11110111111111011101010010001
11000000110101011100000010001
10000000000000000000000010001
100000000000000011010100100011111
11000001110101011111011110E0000001
11110111 1110101 1011110100011111
11111111 1111111 111111111111
11111111 1111111 111111111011
11111111 1111111 111111111011
11111111 1111111 111111111011
11111111 1111111 111111111011
