		NO 			textures/n.xpm
   SO 			textures/s.xpm
   WE 			textures/w.xpm
  EA 			textures/e.xpm



  F 		0,0,0
   C		 72,223,246

1111111111
10000100001
100001000011
1000000000001
100000000011
11100N00111
100000000011111111111111111
1000000000111111111100000001
100001000000000000000000001
100001000011111111111111111
11111111111
