
  F 		40,0,42
   C		 72,223,246

NO 			textures/north_text.xpm
   SO 			textures/south_text.xpm
   WE 			textures/west_text.xpm
  EA 			textures/east_text.xpm



   			





1111111111
10000100001
100001000011
100000000001
100000000011
1110N001111
100000000011111111111111111
1000000000111111111100000001
100001000000000000000000001
100001000011111111111111111
11111111111
