1111111111
1000100011
1001001001
1100000001
1110001101
1000000001
1111111111
