1111111111111
1P00000000001
100000000C001
1000C00000001
1000000000111
100C00C000EC1
1000000000111
1111111111111
