		NO 			textures/north_text.xpm
   SO 			textures/south_text.xpm
   WE 			textures/west_text.xpm
  EA 			textures/east_text.xpm



  F 		0,0,0
   C		 72,223,246

11111111111
10000100001
10000100001
10000000001
10000000001
11100N00111
10000000001
10000000001
10000100001
10000100001
11111111111
