NO 			assets/north_text.xpm
SO 			assets/south_text.xpm
WE 			assets/west_text.xpm
EA 			assets/east_text.xpm
D			assets/door.xpm



  C 		255,255,255
   F		 0,0,0



        1111111111111111111111111
        1000000000110000000000001
        1011000001110000000000001
        1001000000D00000000000001
111111111011000001110000000000001
1000000000110000011101111D1D11111
11110111111111011100000010001
11110111111111011101010010001
11000000110101011100000010001
10000000000000000000000010001
100000000000000011010100100011111
1100000111010101111101111W00000001
11110111 1110101 1011110100011111
11111111 1111111 111111111111
11111111 1111111 111111111011
11111111 1111111 111111111011
11111111 1111111 111111111011
11111111 1111111 111111111011
